couldnt' naak mitak --- good afternoon 
script of german = english
ish = I
ous = from

ish hais gayatri joshi -- i am called gayatri joshi

my four nam ist gayatri -- my first name is gayatri
my naak nam ist joshi
ish, ous indien ous maharashtra-- is

ish vohanain pune
ish bin 

profezzorin - professor
leherrerin - teacher
das ist alles --
velen daank = thank you 

utun
und=and 

japan = yapan 
j = y ( german )
v = f ( german)

journalist ///  yournalist -- same spelling, but pronouncation is different.

tor = gate

brandenburg tor =

fc bianmunich

land = laand -- 

a= aa

german unification day  = 3rd october /1989

bonn = old capital city

Bundes Republik Deutschland = Fedral Republic of Germany, 

berlin is along spree river and tv tower.

S - Bahn , U-Bahn - StraBenBahan - tram - ferries= public transport

frankfurt = frankfoort 
u pronounced as oo
zeil street / frankfurt -- largest shopping street
financial capital 


HAMBURG - pronounced as HAAAMBOORG // 



umlaut  == 2 dots on top of vowels

Munchen
Mu^:nchen -- -MUUNchen -- more stressed.

Bayerische Motorenwerke -- Bavarian Motor Works

KO^:LN = kyoln (pronounciation ) ///cologne -english spelling ---
on banks of river Rhine.  


Black - schwarz
red - rot
golden yellow - gold

may incorporate a central eage shield 

alles klar = understood ?


A- ah
B- Bay
C- tsay
D - Day
E- ay
F- eff
G - gay
H - Ha
I - eee
J - yacht
K - car
J - yacht
K - car
L - ell
M - em
N - en
O - oh
P - pay
Q - Coo
R - air
S - ess
T - tay
U - ooh
V - fow
W -vay
X- ix
Y - oopsilon
Z - tsett

A^:
O^:
U^:

Betaa type letter -- esstett 
used instead of double S 

in german, verb must be at second position

Ja , pronounced as Ya = Yes
Nein = No
 

October Fest -- famous

Fest = festival 

Fasching  = carnival


kinderzeche  -- children's parade

kinder = children 


fussball = fu(beta)ll - football

ice hockey famous


Federbaal == Shuttle ( fedder ) ...   badminton


AAUDI = Audi

BMW - in bavaria state...south germany 

Mercedes -- Ship / aeroplane /cars


--------------
cranken+wagen = ambulance = wagen for patients

-----------------
volks = folks

Porsche 

---

Puma /// POOMa

Lufth = air 

sch = sha


cartofel = potato



Brotsorten /// 

Sauerbraten = sour or pickled
Brot = bread
salat = salad

Mein = mine


